(8,8)
(7,6)
(0,5)
[0,0,0,0,0,0,0,0]
[0,1,1,1,1,1,1,0]
[0,1,0,0,0,0,1,0]
[0,1,1,1,1,0,1,0]
[0,0,0,0,1,0,1,0]
[3,1,1,0,1,0,1,0]
[0,0,1,1,1,0,1,2]
[0,0,0,0,0,0,0,0]
