(11,11)
(6,10)
(9,10)
[0,0,0,0,0,0,0,0,0,0,0]
[0,1,1,1,1,1,1,1,1,1,0]
[0,1,0,0,0,0,0,0,0,1,0]
[0,1,1,1,1,1,1,1,0,1,0]
[0,0,0,0,0,0,0,1,0,1,0]
[0,1,1,1,1,1,1,1,0,1,0]
[0,1,0,0,0,0,0,0,0,1,0]
[0,1,0,0,1,1,1,1,0,1,0]
[0,1,0,0,1,0,0,1,0,1,0]
[0,1,1,1,1,0,1,1,0,1,0]
[0,0,0,0,0,0,2,0,0,3,0]
